4 4 4 4 4 4 4 4 4 4 4 4 4 4 4 4 4 4 4 4
3 0 0 0 0 0 0 0 0 0 0 0 0 0 0 0 0 0 0 2
3 0 0 0 0 0 0 0 0 0 0 0 0 0 0 0 0 0 0 2
3 0 0 0 0 0 0 0 0 0 0 0 0 0 0 0 0 0 0 2
3 0 0 0 0 0 0 0 0 0 0 0 0 0 0 0 0 0 0 0
3 0 0 0 0 0 0 0 0 0 0 0 0 0 0 0 0 0 0 0
3 0 0 0 0 0 0 0 0 0 0 0 0 0 0 0 0 0 0 0
3 0 0 0 0 3 4 4 4 4 4 2 0 0 0 0 0 0 0 2
3 0 0 0 0 3 5 5 5 5 5 2 0 0 0 0 0 0 0 2
3 0 0 0 0 3 5 5 5 5 5 2 0 0 0 0 0 0 0 2
3 0 0 0 0 3 5 5 5 5 5 2 0 0 0 0 0 0 0 2
1 1 1 1 1 1 5 5 5 5 5 1 1 1 1 1 1 1 1 1