4 4 4 4 4 4 4 4 4 4 4 4 4 4 4 4 4 4 4 4
3 0 0 0 0 0 0 0 0 0 0 0 0 0 0 0 0 0 0 2
3 0 0 0 0 0 0 0 0 0 0 0 0 7 0 0 0 0 0 2
3 0 0 0 0 0 0 0 0 0 0 0 0 0 0 0 0 0 0 2
3 0 0 0 0 0 6 0 0 0 0 0 0 0 0 0 0 0 0 0
3 0 0 0 8 0 0 0 0 0 0 0 0 0 0 0 0 0 0 0
3 0 0 0 0 0 0 0 0 0 0 0 0 0 0 0 0 0 0 0
3 0 0 0 0 3 4 4 4 4 4 2 0 0 0 0 8 0 0 2
3 0 7 0 0 3 5 5 5 5 5 2 0 0 0 0 0 0 0 2
3 0 0 0 0 3 5 5 5 5 5 2 0 0 0 0 0 0 0 2
3 0 0 0 0 3 5 5 5 5 5 2 0 0 0 0 0 0 0 2
1 1 1 1 1 1 5 5 5 5 5 1 1 1 1 1 1 1 1 1